$ANSIBLE_VAULT;1.1;AES256
39376232393631653335623936636464313739613162396364306636306231653465393435636630
3630303930616666663832373138326437386330306336360a386137356433313331333031306163
62363638383066353561346130343863623938623331336364386563396235383363366563656366
6136333331366230350a383235393466316330313933656132356334306432633561633337323865
65643631343734383764633561623730353230363464613264323534386135353732656535333861
35333531323665333135666166306166646463626532616235656361383535396535383535336166
32323236333632623539663832366262383563333436653139353834656238643662366139653062
34323163303636646164653066313733353839373431373130626131613665636130643534303930
66393339393030663431313534353234656465326135633334613561333536373435343930343936
37653163643664636561303137663336373563613665656566353030666132633935313331613333
64613030366334616132636363303836633734623430646661336231323039636238656531303736
30373262373262616332386532396134366438666333343462393137653131353563373037306166
32616233396535643861386166656665333033393234653165316231393039383565313466393663
65353462333630303032653136346536633863616463336562333834656665376635393262336535
61326639663939393261373463376533376533666563633237326461653134363030633330346132
36326466623631656462383438366263313337613265346234386134346438366232356637663933
37316464303365393066383661373836353936636666366162353731393635343132366537353766
39353862376332343335323738316237633863633136376538373835636338306437636235623237
64326639303966303034633632336666393161313035633339623734613038396138383566643963
61343538326333373365626638623730303663643034643732343635356438363866343432636539
32353737643139373862353438653936653138373031336563386236666531323166303664663631
36303133323365346536343132373965633035373531343164656261363038393265666439333039
64386164643030333336613965653535623533613032636535303864616437613130383731386462
35343835346364343334396438346666313434636461393436636430303335613935386563646637
3132
